1111111111111111111111111
100X0000000000000000001C1
1111EX00010000000000000C1
1P000X0001001111111100001
1111111111111111111111111