1111111111111111111111111
110001100E000C000000001C1
1011101111010111111100101
1011101111010111111100101
10111010C001C0000111001C1
1011101111010111111100101
10111011110101111111000C1
11P0000000010000000000001
1111111111111111111111111