1111111111111111111111111
10000000000000000000001C1
1111E000010000000000000C1
1P00000001001111111100001
1111111111111111111111111