111111
1000C1
101111
1P1CE1
111111