1111111
10E0001
1011001
1P10001
1111011