1111111
1000001
1011001
1P10C01
1111111