111111
1001C1
111111
1P0CE1
111111