1111111
1PE10C1
1111111
111111
1111111
1111111
111111