111111
1001C1
1111C1
1P00E1
111111