1111111
1000E01
1011001
1010C01
1111111
