111111111111111
1000C1111111111
100001000001111
1P1001000000CE1
111111111111111