1111111
10E0E01
1011001
1P10C01
1111111