1111111111111111111111111
10000000000000000000001C1
11110000010000000000000C1
1P00E00001001111111100001
1111111111111111111111111