111111
1001C1
111111
1P00E1
111111
