1111111
1PE10C1
1000001
1111111