1111111
10E00C1
1P00001
1111111
