1111111
10E00C1
1P00C01
1111111
